20 11

22 22 22 22 22 22 22 22 22 22 22 22 22 22 22 22 22 22 22 22
22 22 22 22 22 22 22 22 22 22 22 22 22 22 22 22 22 22 22 22
22 22 22 22 22 22 22 22 22 22 22 22 22 22 22 22 22 22 22 22
22 22 22 22 22 22 22 22 22 22 22 22 22 22 22 22 22 22 22 22
22 22 22 22 22 22 22 22 22 22 22 22 22 22 22 22 22 22 22 22
22 22 22 22 22 22 22 22 22 22 22 22 22 22 22 22 22 22 22 22
22 22 22 22 22 22 22 22 22 22 22 22 22 22 22 22 22 22 22 22
22 22 22 22 22 22 22 22 22 22 22 22 22 22 22 22 22 22 22 22
22 22 22 22 22 22 22 22 22 22 22 22 22 22 22 22 22 22 22 22
22 22 22 22 22 22 22 22 22 22 22 22 22 22 22 22 22 22 22 22
22 22 22 22 22 22 22 22 22 22 22 22 22 22 22 22 22 22 22 22

0 0 0 0 0 0 0 0 0 0 0 0 0 0 0 0 0 0 0 0
0 0 0 0 0 0 0 0 0 0 0 0 0 0 0 0 0 0 0 0
0 0 0 0 0 0 0 0 0 0 0 0 0 0 0 0 0 0 0 0
0 0 0 0 0 0 0 0 0 0 0 0 0 0 0 0 0 0 0 0
0 0 0 0 0 0 0 0 0 0 0 0 0 0 0 0 0 0 0 0
0 0 0 0 0 0 0 0 0 0 0 0 0 0 0 0 0 0 0 0
0 0 0 0 0 0 0 0 0 0 0 0 0 0 0 0 0 0 0 0
0 0 0 0 0 0 0 0 0 0 0 0 0 0 0 0 0 0 0 0
0 0 0 0 0 0 0 0 0 0 0 0 0 0 0 0 0 0 0 0
0 0 0 0 0 0 0 0 0 0 0 0 0 0 0 0 0 0 0 0
0 0 0 0 0 0 0 0 0 0 0 0 0 0 0 0 0 0 0 0

155 156 0 0 0 0 0 0 0 0 0 0 0 0 0 0 0 0 226 205
155 156 0 0 0 0 0 0 0 0 0 0 0 0 0 0 186 0 206 225
155 156 0 0 0 0 0 0 0 186 0 0 0 0 0 0 0 0 226 205
155 156 0 0 0 0 0 0 0 0 0 0 0 0 0 0 0 0 206 225
155 156 0 0 0 0 0 0 0 0 0 0 0 0 0 0 0 0 226 205
155 156 0 0 0 0 0 0 0 0 0 0 0 0 185 0 0 0 206 225
155 156 0 0 0 185 0 0 0 0 0 0 0 0 0 0 0 0 226 205
155 156 0 0 0 0 0 0 0 0 0 0 0 0 0 0 0 0 206 225
155 156 0 0 0 0 0 0 0 0 0 0 185 0 0 0 0 0 226 205
155 156 0 0 186 0 0 0 0 0 0 0 0 0 0 0 0 0 206 225
155 156 0 0 0 0 0 0 0 0 0 0 0 0 0 0 0 0 226 205
