20 11

22 22 22 22 22 22 22 22 22 22 22 22 22 22 22 22 22 22 22 22
22 22 22 22 22 22 22 22 22 22 22 22 22 22 22 22 22 22 22 22
22 22 22 22 22 22 22 22 22 22 22 22 22 22 22 22 22 22 22 22
22 22 22 22 22 22 22 22 22 22 22 22 22 22 22 22 22 22 22 22
22 22 22 22 22 22 22 22 22 22 22 22 22 22 22 22 22 22 22 22
22 22 22 22 22 22 22 22 22 22 22 22 22 22 22 22 22 22 22 22
22 22 22 22 22 22 22 22 22 22 22 22 22 22 22 22 22 22 22 22
22 22 22 22 22 22 22 22 22 22 22 22 22 22 22 22 22 22 22 22
22 22 22 22 22 22 22 22 22 22 22 22 22 22 22 22 22 22 22 22
22 22 22 22 22 22 22 22 22 22 22 22 22 22 22 22 22 22 22 22
22 22 22 22 22 22 22 22 22 22 22 22 22 22 22 22 22 22 22 22

0 0 0 0 0 0 0 0 0 0 0 0 0 0 0 0 0 0 0 0
0 0 0 45 0 0 0 0 0 0 0 0 0 0 0 0 0 0 0 0
0 0 0 0 0 0 0 0 44 0 0 0 0 24 0 0 0 0 0 0
0 0 0 0 0 0 0 0 0 0 0 0 0 0 0 0 0 0 0 0
0 0 0 0 0 0 0 0 0 0 0 0 0 0 0 0 0 0 0 0
0 0 0 0 0 0 0 0 0 0 45 0 0 0 0 0 0 0 0 0
0 0 0 0 0 0 0 0 0 0 0 0 0 0 0 0 0 0 0 0
0 0 0 0 0 0 0 0 0 0 0 0 0 0 0 0 0 0 0 0
0 0 0 0 24 0 0 0 0 0 0 0 0 45 0 0 0 0 0 0
0 0 0 0 0 0 0 0 0 0 0 0 0 0 0 0 0 0 0 0
0 0 0 0 0 0 0 0 0 0 0 0 0 0 0 0 0 0 0 0

155 156 0 0 0 0 0 0 0 0 0 0 0 0 0 0 0 0 179 180
155 156 0 0 0 0 0 0 0 0 0 0 0 0 0 0 241 0 119 120
155 156 0 0 0 0 0 0 0 242 0 0 0 0 0 0 0 0 139 140
155 156 0 0 0 0 0 0 0 0 0 0 0 0 0 0 0 0 159 160
155 156 0 0 0 0 0 0 0 0 0 0 0 0 0 0 0 0 179 180
155 156 0 0 0 0 0 0 0 0 0 0 0 0 242 0 0 0 119 120
155 156 0 0 0 241 0 0 0 0 0 0 0 0 0 0 0 0 139 140
155 156 0 0 0 0 0 0 0 0 0 0 0 0 0 0 0 0 159 160
155 156 0 0 0 0 0 0 0 0 0 0 0 0 0 0 0 0 179 180
155 156 0 0 242 0 0 0 0 0 0 0 0 0 0 0 0 0 119 120
155 156 0 0 0 0 0 0 0 0 0 0 0 0 0 0 0 0 139 140
