20 11

22 22 22 22 22 22 22 22 22 22 22 22 22 22 22 22 22 22 22 22
22 22 22 22 22 22 22 22 22 22 22 22 22 22 22 22 22 22 22 22
22 22 22 22 22 22 22 22 22 22 22 22 22 22 22 22 22 22 22 22
22 22 22 22 22 22 22 22 22 22 22 22 22 22 22 22 22 22 22 22
22 22 22 22 22 22 22 22 22 22 22 22 22 22 22 22 22 22 22 22
22 22 22 22 22 22 22 22 22 22 22 22 22 22 22 22 22 22 22 22
22 22 22 22 22 22 22 22 22 22 22 22 22 22 22 22 22 22 22 22
22 22 22 22 22 22 22 22 22 22 22 22 22 22 22 22 22 22 22 22
22 22 22 22 22 22 22 22 22 22 22 22 22 22 22 22 22 22 22 22
22 22 22 22 22 22 22 22 22 22 22 22 22 22 22 22 22 22 22 22
22 22 22 22 22 22 22 22 22 22 22 22 22 22 22 22 22 22 22 22

0 0 0 0 0 0 0 0 0 0 0 0 0 0 0 0 0 0 226 0
0 0 0 0 0 0 0 0 0 0 0 0 0 0 0 0 0 0 206 0
0 0 0 0 0 0 0 0 0 0 0 0 0 0 0 0 0 0 226 0
0 0 0 0 0 0 0 0 0 0 0 0 0 0 0 0 0 0 206 0
0 0 0 0 0 0 0 0 0 0 0 0 0 0 0 0 0 0 226 0
0 0 0 0 0 0 0 0 0 0 0 0 0 0 0 0 0 0 206 0
0 0 0 0 0 0 0 0 0 0 0 0 0 0 0 0 0 0 226 0
0 0 0 0 0 0 0 0 0 0 0 0 0 0 0 0 0 0 206 0
0 0 0 0 0 0 0 0 0 0 0 0 0 0 0 0 0 0 226 0
0 0 0 0 0 0 0 0 0 0 0 0 0 0 0 0 0 0 206 0
0 0 0 0 0 0 0 0 0 0 0 0 0 0 0 0 0 0 226 0

155 156 0 0 0 0 0 0 0 0 0 0 0 0 0 0 0 0 0 205
155 156 0 0 0 0 0 0 0 0 0 0 0 0 0 0 0 0 0 225
155 156 0 0 0 0 0 0 0 0 0 0 0 0 0 0 0 0 0 205
155 156 0 0 0 0 0 0 0 0 0 0 0 0 0 0 0 0 0 225
155 156 0 0 0 0 0 0 0 0 0 0 0 0 0 0 0 0 0 205
155 156 0 0 0 0 0 0 0 0 0 0 0 0 0 0 0 0 0 225
155 156 0 0 0 0 0 0 0 0 0 0 0 0 0 0 0 0 0 205
155 156 0 0 0 0 0 0 0 0 0 0 0 0 0 0 0 0 0 225
155 156 0 0 0 0 0 0 0 0 0 0 0 0 0 0 0 0 0 205
155 156 0 0 0 0 0 0 0 0 0 0 0 0 0 0 0 0 0 225
155 156 0 0 0 0 0 0 0 0 0 0 0 0 0 0 0 0 0 205
